6666666666666666666666666666666666666666666666666666666666666666666666666666666666666666666666666666666666666666666666666666666666666666666666666666666666666666666666666666666666666666666666666666666666666666666666666666666666666666666666666666666666666666
600000000000000000000000000000000000000000000000666600000000000000000000000000000000000000000000000666000077777777777777777777777700000ddd00d000d0d000d0d0000000000000000000000000000000000000000000000000000000000000000000000000000000000000000000000000000000
600000000000000000000000000000000000000000000000666600000000000000000000000000000000000000000000000666000077777777777777777777777700000d0d00d000d0dd00d0d0000000000000000000000000000000000000000000000000000000000000000000000000000000000000000000000000000000
60000000000000000000000000c000000000000000000000000000000000000000000000000000000000000000000000000000000077777777777777777777777700000dd000d000d0d0d0d0d0000000000000000000000000000000000000000000000000000000000000000000000000000000000000000000000000000000
6000000000000000000000000000000000000000000g000000000000000000000000700e0000000e0000000e0000000e000000000000000000000000000000000000000d0d00d000d0d00dd000000000000000000000000000000000000000000000000000000000000000000000000000000000000000000000000000000000
6000000000000000f0000007j777j7000000000000000000000000000000000000000000000000000000000000000000000000000000000000000000000000000000000d00d00ddd00d000d0d000000000000000000000000000000000000000000000000000000000000000000000000000000000000000000000k00000k000
60000000000000000000000777777700000000000000000066660000000000000000000000000000000000000000000000066600000000000000000000000k0000000000000000000000000000000000000000k0000k00000000k00k00k00k000000000000000000000000000000000000000000000000000000000000000000
60000000f00000000000000000000000000000000000000066660000j0000070000000000000000000000000000000000006660000000000000000000000000000000000000000000000000000000000000000000000000000000000000000000000000000000000000000000000000000000000000000000777777777777777
60000000000000000000000000000000000f0000000000006666000000000000000000000000000000000000000000000006660000777777777777777777777777777777777777777777777777777777777777777777777777777777777777777700000000777700000000000000000000000000000000077777777777777777
6000077000000000000000000000000000000000000000006666000000000000000000000000000000000000000000000006660000777777777777777777777777777777777777777777777777777777777777777777777777777777777777777700000000777700000000000000000000000000000007777777777777777777
600007700000000000000f000000f0000000000000000000666600000000000000000000000000000000000000000000000666000077777777777777777777777777777777777777777777777777777777777777777777777777777777777777770000000077770l0l0l0l0l0l0l0l0l0l0l0l0l0l0777777777777777777777
6666666hhhhhhhhhhhhhhhhhhhhhhhhhhhhhhhhhhhhhhhhh6666hhhhhhhhhhhhhhhhhhhhhhhihhhhhhhihhhhhhhihhhhhhh666hhih7777777777777777777777777777777777777777777777777777777777777777777777777777777777777777hhihhihh777777j777j777j777j777j777j777j77777777777777777777777


